tr|true|json
a|anew|tsserver-typescript
le|let|tsserver-typescript
docu|document|tsserver-typescript
consoe|console|tsserver-typescript
charact|character|tsserver-javascript
nu|null|file
session_|session_name|around
sess|session|around
filter|filters_data_keys|solargraph
filter|filters_data|around
filters|filters_data|around
filt|filters_data|around
sea|search_filters|buffer
:landlord_s|:landlord_slug|solargraph
par|params|buffer
filters_|filters_data|around
landlord|landlord_slug|buffer
landlord_|landlord_slug|buffer
landlord|landlord|around
BuildingFi|BuildingFilters|solargraph
Cap|Capsule|solargraph
land|landlord|around
bybug|byebug|around
s|scope|solargraph
filter|filter_by_live_status|solargraph
LIVE|LIVE_STATUS|buffer
country|country_code|around
para|param_landlord_slug|around
notab|notable_tenants|around
landlord_slu|landlord_slug|buffer
:for_lan|:for_landlord|solargraph
la|lambda|solargraph
landlo|landlord_slug|around
for_lan|for_landlord|buffer
Buildin|Building|around
param_|param_landlord_slug|around
pram|params|around
for_lanl|for_landlord|buffer
max_s|max_sqmt|around
min_s|min_sqmt|around
rentable_bui|rentable_building_area|around
float|float8|around
manit|magnitude|around
min_sqmt|min_sqmt|around
min_sq|min_sqmt|around
max_sq|max_sqmt|around
scope|scope|around
ren|rentable_building_area|around
max_sqmt|max_sqmt|around
min_|min_sqmt|around
coun|country_code|around
en|endif|around
NERDTree|NERDTreeFind|around
NERDTreeTo|NERDTreeToggle|around
useState|useState|tsserver-typescript
useSta|useState|tsserver-typescript
useS|useState|tsserver-javascript